lame=unimpressive
Lame=Unimpressive
LAME=UNIMPRESSIVE
crazy=wild
Crazy=Wild
CRAZY=WILD
stupid=silly
Stupid=Silly
STUPID=STUPID
psychotic=peculiar
Psychotic=Peculiar
PSYCHOTIC=PECULIAR
nuts=frustrating
Nuts=Frustrating
NUTS=FRUSTRATING
dumb=ignorant
Dumb=Ignorant
DUMB=IGNORANT
insane=amazing
Insane=Amazing
INSANE=AMAZING
crackhead=dazed
Crackhead=Dazed
CRACKHEAD=DAZED
pioneer=trailblazer
Pioneer=Trailblazer
PIONEER=TRAILBLAZER
crusader=champion
Crusader=Champion
CRUSADER=CHAMPION
walkabout=excursion
Walkabout=Excursion
WALKABOUT=EXCURSION
manhood=personhood
Manhood=Personhood
MANHOOD=PERSONHOOD
businessman=executive
Businessman=Executive
BUSINESSMAN=EXECUTIVE
businessmen=executives
Businessmen=Executives
BUSINESSMEN=EXECUTIVES
freshman=1st year
Freshman=1st year
FRESHMAN=1ST YEAR
freshmen=1st year
Freshmen=1st year
FRESHMEN=1ST YEAR
mankind=humankind
Mankind=Humankind
MANKIND=HUMANKIND
master=head
Master=Head
MASTER=HEAD
duh=ofcourse
Duh=Ofcourse
DUH=OFCOURSE
crippled=nonfunctional
Crippled=Nonfunctional
CRIPPLED=NONFUNCTIONAL
derp=obvious
Derp=obvious
DERP=OBVIOUS
uppity=arogant
Uppity=Arogant
UPPITY=AROGANT
moron=fool
Moron=Fool
MORON=FOOL
spaz=energetic
Spaz=Energetic
SPAZ=ENERGETIC
cakewalk=breeze
Cakewalk=Breeze
CAKEWALK=BREEZE
guru=authority
Guru=Authority
GURU=AUTHORITY
nazi=stickler
Nazi=Stickler
NAZI=STICKLER
